22111111111122
11011111111011
11101111101111
11121200212111
11101200210111
11011111111011
22111111111122